1111111111111111111111111111111111111111111111111
10000000000000000000000000000000000000000000000E1
1011111111101111111111110111111111110111111111101
10C00000000000000000000000000000000000000000000C1
1010111011101110111011101110111011101110111011101
1000100000000000000000000000000000000000000000001
1110111011111111111011101111111111111011111111101
1P001000000000C00000000000000C0000000000000000001
1010111011101110111011101110111011101110111011101
10C00000000000000000000000000000000000000000000C1
1011111111101111111111110111111111110111111111101
1000000000000000000000000000000000000000000000001
1111111111111111111111111111111111111111111111111