111111111111111111111111
1P0000000000000000000001
100000000000000000000001
10111CC01111011110111101
101C1CC0CCC10CCC101CC101
10CC1CC01111011110CCC101
10CC1CC0CCC10CCC10CCC101
101111101111011110CCC101
100000000000000000000001
1000000000000000000000E1
111111111111111111111111