11111111111111111
1P011111111111
100000000C00000E1
11111111111111111