11111111111111111111111111111
100000000000000000000000000E1
10111111111011111111111111101
10C000000000000000000000000C1
10101110111011101110111011101
10001000000000000000000000001
11101110111111111011111111101
1P001000000000C00000000000001
10101110111011101110111011101
10C000000000000000000000000C1
10111111111011111111111111101
10000000000000000000000000001
11111111111111111111111111111