111111111111111111111111
1P00000000000000000000C1
100000000000000000000001
101110001111011110111101
101C100000C1000C1010C101
100010001111011110000101
10001C0000C1000C10000101
101111101111011110000101
100000000000000000000001
1000000000C00000000000E1
111111111111111111111111